##########                    ;
#@.......#                    ;
#........#                    ;
#.....g..########             ;
#........|.aw..E#             ;
#################             ;