###########################         ;
#.........................#         ; 
#.........................#         ; 
#.....g...................#         ; 
#.........................#         ; 
#############.#############         ; 
#############.#############         ; 
#############.#############         ; 
#############.#############         ; 
#.........................#         ; 
#.........................#         ; 
#.....................@...#         ; 
#.........................#         ; 
###########################         ;
