###########         ###########                                 ;
#@.a..~~..#         #......g..#                                 ;
#.....~~..#         #..w......#                                 ;
#...g.....###########..    ...#                                 ;
#.........|.........|..    ...#                                 ;
#####################.........#                                 ;
                    #####|#####                                 ;
                    #   #.# #!#                                 ;
          ###########   #.# #.#                                 ;
          #!....T...#   #.###.#                                 ;
          #v........#   #.|...#                                 ;
###########.........#####|##########                            ;
#.........|........!#.........#...!#                            ;
#.>.......###########.........#.g..#                            ;
#.........|.....g...#.........#....#                            ;
#.........#...g.....|.........#....#                            ;
#.........###########.........#.####                            ;
#.........#.........#.........#.#                               ;
#.........#..g......#..g......#.#                               ;
#.........#.........#.........|.#                               ;
#..g......#.........#.....g...###                               ;
#.........#......g..#.........#                                 ;
#.........#.........###########                                 ;
#.........|.........#                                           ;
#####################                                           ;